aback	surprised; startled
abate	to lessen; to decrease
abdicate	to give up
abduct	to take away; to kidnap
aberration	abnormality
abet	to aid; to encourage
abeyance	a postponement
abhor	to hate
abide	to remain or to put up with
abject	miserable
abjure	to give up (rights); to deny
ablution	cleansing
abolition	doing away with
abominate	to dislike strongly
aborigine	original inhabitant
abortive	unsuccessful
abrade	to wear or scrape away
abridge	to shorten or diminish
abrogate	to abolish
abscond	to leave secretly
absolve	to free from responsibility
abstemious	to show moderation in eating or drinking
abstinence	self-denial; voluntary restraint
abstract	lacking substance; theoretical
abut	to border on; adjoin
abysmal	extremely bad
abyss	a bottomless pit; vast
academic	theoretical or pertaining to school
accede	to agree to; accept
accessible	easy to approach
acclaim	to greet with approval; praise
acclimate	to get used to
acclivity	an upward slope
accolade	honor or award
accommodate	to make fit; to help
accord	agreement
accost	to approach or speak to aggressively
accouterments	equipment or accessories
accredit	to certify or increase
accretion	an addition or increase
accrue	to accumulate
acerbic	sharp; bitter; sour
acoustic	dealing with sound
acquiesce	to agree; accept
acquit	to find not guilty
acrid	bitter; irritating
acrimonious	harsh; speech or action
acronym	word formed from initials of other words
actuate	to put into action
acuity	sharp perception
acumen	mental insight
acute	sharp; intense
adage	a familiar saying
adamant	unyielding
addend	something added to another
addled	confused; muddled
adduce	something offered as proof
adept	highly skilled
adhere	to stick; to support
adjudicate	to judge
adjunct	an assistant or in addition to
admonish	to warn
adroit	skillful; shrewd
adulation	praise or flattery
adulterate	to make impure
advent	a coming or arrival
adventitious	accidental; incidental
adversary	enemy; an opponent
advocate	to support; to defend another
aegis	protection
aesthetic	pertaining to beauty
affable	agreeable
affectation	phony attitude or behavior
affiliation	to associate with
affinity	any attraction to
affirmative	positive
affix	to attach or add
affluence	wealth
agape	open-mouthed; sign of surprise
agenda	list of things to be done
aggrandize	to make greater
aggravate	to irritate
aggregate	to collect or gather together
aghast	shocked
agile	to move quickly
agitate	to stir up
agnostic	one who doubts the existence of God
agrarian	pertaining to farmers and agriculture
alacrity	willingness
alias	an assumed name
alienate	to make others unfriendly to you
allay	to calm
allege	to charge without proof
alleviate	to lessen, lighten, or relieve
allocate	to assign for a specific purpose
allude	to hint at
aloft	high in the air
aloof	cool; indifferent
altercation	an argument
altruism	concern for others
amalgamate	to combine or unite
amass	to accumulate
amazon	strong, masculine woman
ambient	surrounding
ambiguous	unclear, vague
ambivalence	conflicting feelings toward something
ambulatory	able to walk
ameliorate	to improve; make better
amenable	agreeable
amend	to change
amenity	courtesy or agreeableness
amiable	friendly
amicable	agreeable
amiss	wrong; improper
amity	friendship
amnesty	official pardon for an offense
amoral	no sense of right and wrong
amorous	loving
amorphous	shapeless
amphibious	able to live on both land and water
ample	abundant
amplify	to make greater
amulet	a charm worn to keep evil away
anachronism	something out of place or time
analgesic	drug that reduces pain
anarchy	absence of government or order
anathema	a curse; a person strongly disliked
ancillary	subordinate
anecdote	a short, entertaining story
anent	concerning
animosity	hostility
annals	historical records
annihilate	to totally destroy
annuity	income paid at stated intervals
annul	to cancel
anomalous	abnormal; irregular
anoxia	lack of oxygen
antagonistic	hostile
antecedent	that which goes before something else in time
anthology	collection of literary works
anthropoid	resembling man
anticipate	to prepare for in advance
anticlimax	something unimportant coming after something special
antic	playful or silly act
antidote	a remedy
antipathy	strongly dislike
antiquated	extremely old
antithesis	an exact opposite
apathy	indifference; lack of interest or emotion
aperture	an opening
apex	the highest point
aphasia	loss of the ability to speak
aphorism	brief saying; a short proverb
aplomb	self-confidence
apocryphal	mythical; doubtful in origin
apoplexy	sudden loss of consciousness; paralysis
apostate	one who gives up his beliefs
appall	to frighten; dismay
apparition	a ghost
appease	to satisfy
appellation	a name
append	to add to
apprehend	to catch; to understand
apprehensive	fearful; anxious
apprise	to inform
approbation	approval
appropriate	to take possession of; satisfactory
apropos	appropriate; fitting
arbiter	a judge; referee
arbitrary	biased or at random
arbor	a shaded area
arcane	mysterious or secret
archaic	out-dated
archetype	original
archipelago	group of islands
archives	public records and documents
ardent	strongly enthusiastic
arduous	difficult
arid	dry
array	an orderly arrangement
arrears	in debt
arrogant	haughty; conceited; snooty
artful	cunning; crafty
articulate	to speak clearly
artifact	a simple, handmade object
artifice	deception
artisan	a skilled craftsman
ascendant	rising; dominant
ascertain	to find out
ascetic	self-denial
ascribe	to attribute
aseptic	without bacteria
asinine	stupid or silly
askance	to look at suspiciously
askew	crooked; out of position
aspersion	a damaging remark
aspire	to have an ambition
assail	to attack
assay	to test
assent	to agree
assertive	confident
assess	to estimate the value of, measure
assiduous	diligence; care
assimilate	to absorb
assuage	to calm; to soothe
astray	in the wrong direction
astringent	substance that contracts blood vessels
astute	very smart; clever
asunder	into separate parts
asylum	a refuge
atone	to make up for
atrocious	cruel; awful
atrophy	to become useless; waste away
attenuated	weakened
attest	to confirm
attribute	to assign to; a characteristic
attrition	a wearing down
atypical	not usual
audacity	boldness
audible	capable of being heard
audit	to examine accounts or records
augment	to increase or enlarge
augur	to predict
august	majestic; worthy of respect
aura	a glow
aural	pertaining to the sense of hearing
auroral	rosy
auspicious	favorable; fortunate
austere	severe; self-disciplined
authenticate	to confirm
authoritarian	bossy, like a dictator
authoritative	trustworthy; having power
autocratic	unlimited authority
autonomy	self-rule
avarice	greed; money hungry
avenge	to get revenge
aversion	intense dislike
avert	to prevent; to turn away
avid	enthusiastic
avocation	a hobby
avow	to declare openly
awry	in the wrong direction
badger	to annoy
baffle	to confuse
baleful	harmful
balk	to stop short; to refuse to act
balm	something that calms or soothes
banal	ordinary; trivial; common; dull
bandy	to converse
bane	cause of harm or distress
bank	to put a wall around
banter	teasing
bard	a poet
baroque	over decorated; very ornate
barrage	heavy attack
barrister	lawyer (British)
bask	to lie in the sun
bastion	a strong defense; a fort
bauble	trinket
bawdy	humorously obscene
bayou	marshy body of water
bedlam	a noisy uproar
beget	to produce
begrudge	to resent another's success
beguile	to deceive
behemoth	huge animal
belated	delayed
beleaguer	to annoy
belittle	to put down; disparage
belligerent	quarrelsome
benediction	blessing
benefactor	one who helps another; a donor
beneficiary	one who receives benefits
benevolent	generous; kindly
benignant	kindly; gentle
benign	harmless
bequeath	to hand down
berate	to scold severely
bereave	to leave in a sad state
berserk	violently destructive
beseech	to appeal to
beset	to attack
besiege	to close in on
besmirch	to make dirty
bestial	savage
bestow	to give or present
betrothed	engaged
bevy	a large group
bias	preference; prejudice for; not neutral
bibliophile	lover of books
bibulous	very absorbent
bicker	to quarrel
bide	to wait
biennial	occurring every two years
bigot	prejudiced person
bilious	bad-tempered
bilk	to swindle
binge	a spree
bivouac	temporary shelter
blanch	to make pale; to avoid or pull back from
blasé	unexcited; indifferent
blasphemy	disrespect for holy things; irreverence
blatant	conspicuous; offensively noisy and loud
blazon	to display; to proclaim
bleak	unsheltered; gloomy
bleary	blurred; dimmed
blight	destruction or withering disease
bliss	extreme happiness
blithe	carefree
bludgeon	a heavy club
blunt	abrupt in speech or manner; having a dull edge
blurt (out)	to utter suddenly or indiscreetly
bluster	to speak noisily; to boast
bode	to indicate in advance, as an omen does
bogus	false, fake
bolster	to prop up; to support
bolt	to dash out suddenly; to discontinue support of
bombastic	using impressive but meaningless language
bona fide	genuine
bondage	slavery
boon	a benefit
booty	stolen money or goods
boreal	northern
borne	carried
botch	to mess up; to bungle
bounty	a reward; goodness
bourgeoisie	middle class
bovine	pertaining to oxen or cattle
braggart	one who brags
brandish	to shake or wave a weapon aggressively
brash	rude; aggressive
bravado	false bravery
brawn	muscular strength
brazen	shameless
breach	a violation or a gap
breadth	width
brevity	briefness; concise
brine	salt water
brisk	lively; quick
broach	to introduce or bring up
browbeat	to intimidate
brunt	the main force or impact, as of a blow
brusque	abrupt in manner, blunt; rough
bucolic	pertaining to the countryside; rural
buffoon	a fool
bulbous	swollen; bulb shaped
bulwark	a strong defense
bumptious	arrogant
bungle	to do things clumsily
buoyant	to float; lively
bureaucracy	system of government through departments
burgeon	to grow rapidly
burlesque	a speech or action that treats a serious subject with ridicule
burly	muscular
burnish	to polish
buttress	to prop up or support
cabal	a small group
cache	a hiding place
cacophony	unpleasant sound
cadaver	a dead body
cadence	rhythm
cajole	to persuade
calamitous	causing trouble or disastrous
calligraphy	fancy handwriting
callous	unyielding; insensitive
callow	young end inexperienced
camaraderie	loyalty; friendship
canard	a false story, report, or rumor
candid	truthful, honest
candor	honest, openness, frankness
canine	pertaining to dogs
canny	shrewd
canon	rule
cantankerous	bad-tempered
canter	smooth, easy pace
cant	statements made in a singsong tone
canvass	to make a survey
capacious	spacious
capitulate	to surrender
capricious	erratic, impulsive
captions	heading or titles
captivate	to capture or to charm
carcinogenic	causing cancer
cardinal	of major importance
careen	to swerve
caret blanche	freedom to use one's own judgment
caricature	an exaggerated portrayal
carnage	slaughter
carnal	sensual; sexual
carnivorous	flesh-eating
carouse	to engage in a noisy, wild party
carp	to complain
carrion	decaying flesh
cartel	association of businesses
cascade	to fall
caste	social class
castigate	to punish or criticize
casualty	an accident; one who is injured
cataclysm	a violent change
catacomb	underground burial place
catalyst	person or thing that speeds up a result
cataract	large waterfall; cloudiness of the eye
catastrophe	disaster
catharsis	act of purification
catholic	universal; found everywhere
caucus	a meeting
caustic	severely critical
cauterize	to burn
cavalcade	a sequence of events
cavalier	a casually indifferent person
caveat	a warning
cavil	to argue
cavort	to frolic
celerity	swiftness
celestial	heavenly
celibate	unmarried
censor	to eliminate objectionable material
censure	to criticize or condemn
centrifugal	moving away from the center
certitude	certainty
cessation	stopping
chafe	to annoy
chaff	worthless material
chagrin	embarrassment
chameleon	a changeable person
chaos	complete disorder
charisma	great appeal or attraction
charlatan	a fake
chary (of)	careful
chasm	a wide gap
chaste	pure
chastise	to punish; to purify
chattel	slave
chauvinism	fanatical devotion to one's country, sex, religion, etc.
cherub	an innocent person
chicanery	trickery
chic	stylish
chide	criticize
chimerical	imaginary; fantastic; unreal
chivalrous	courteous, courageous
choleric	easily angered
chronic	long-lasting
churlish	rude
cipher	a thing of no value
circuitous	indirect
circumlocution	roundabout way of speaking
circumscribe	to encircle
circumspect	cautious
circumvent	to surround or entrap; to go around or by-pass
citadel	a fortress
cite	to quote a passage, book, author, etc; to refer to an example
civility	politeness
clairvoyant	having great insight; keenly perceptive
clamber	to climb with effort or difficulty
clamor	noise
clandestine	secretive; private
clangor	harsh ringing sound
clarify	to make clear
clarion	clear and shrill
claustrophobia	fear of enclosed spaces
cleave	to split something apart to stick or cling to something
cleft	split; divided
clemency	mercy; leniency
cliché	a trite or worn-out expression
clientele	customers
clime	climate; region
clique	a small, exclusive group
cloistered	secluded; confined
clout	(colloquial) power; influence
cloven	divided; split
coalesce	to blend, to merge, to fuse
coddle	to treat tenderly
coerce	to force
coffer	a strongbox
cogent	convincing
cogitate	to think; to consider carefully
cognate	related; relevant
cognizant	aware of
coherent	logically connected; consistent
cohesive	tending to stick
cohort	colleague; associate; partner
coincide	to occur simultaneously
collaborate	to work together; to cooperate
collage	collection of various bits and pieces
collateral	security for payment
collate	to put together in order
colloquial	informal conversation or phrase
collusion	conspiracy; agreement to commit a crime
colossal	huge; enormous
combative	argumentative
combustible	capable of catching fire easily
comely	attractive
commemorate	honoring; remembering
commence	to begin
commendation	praise
commensurate	proportionate
commiserate	to express pity for
commodious	spacious
communal	shared
compact	firmly packed; a treaty
compatible	agreeable; harmonious
compel	to force
compendium	brief summary
compensatory	paying back
complacent	satisfied; smug; overly competent
complement	to make whole; to complete
compliant	yielding; submissive
complicity	partnership in wrongful act
component	elements or parts
composure	calmness of mind or manner
comprehensive	all inclusive
compromise	to agree; to settle by concession
compulsory	required
compunction	uneasiness, remorse
concave	curved inward
concede	to admit
concentrate	to think deeply; to increase in strength or degree
concentric	having a common center
conception	a beginning; original plan
concession	allowance; the act of yielding
conciliate	to soothe the anger of; to win over
concise	to the point; brief
conclave	secret meeting
conclusive	end result
concoct	to invent
concomitant	accompanying
concord	agreement
concourse	a crowd; a wide street
concur	to agree with
condescend	to talk down to someone
condign	deserved
condolence	expression of sorrow
condone	to excuse; to overlook; to forgive
conducive	leading to
conduit	pipe or tube
configuration	shape
confiscate	to seize
conflagration	a large fire
confluent	flowing together
conformity	doing the same as others
confounded	confused or amazed
congeal	to thicken
congenial	friendly
congenital	existing at birth
conglomerate	mass; large corporation
congregate	to assemble
congruent	in agreement
conjecture	to guess or speculate
conjugal	pertaining to marriage
conjure	to call upon or to command a devil or spirit to practice magic; cast a spell
connivance	conspiracy
connoisseur	an expert
connote	imply
connubial	relating to marriage
consanguinity	close relationship by blood
consecrate	to make holy
consensus	general agreement
console	to comfort
consonant	in agreement or harmony
consort	a husband or wife; to associate or join
conspicuous	obvious; easily seen
consternation	confusion or panic
constituents	supporters
constraints	limitations
constrict	to shrink
construe	to interpret
consummate	to complete or perfect
contagious	infectious
contemporary	current; modern
contemptuous	scornful; hateful; (to disdain)
contentious	argumentative; quarrelsome
contort	to distort
contrary	opposite to
contravene	to oppose
contrite	sorrowful; remorseful; apologetic
contumacious	disobedient; stubborn
contusion	a bruise
conundrum	a riddle or puzzle
convene	to assemble
conventional	ordinary; usual
converge	to come together
conversant	being familiar with
converse	to talk; the opposite
convex	curving outward
conveyance	a vehicle
convivial	friendly
convoluted	twisted
cope	to deal with
copious	abundant
coquetry	flirtation
cordial	friendly
cornucopia	abundance
corollary	a deduction; a result of
corona	bright circle
corporeal	body or physical
corpulent	fatness
corroborate	to confirm
corrugated	wrinkled; ridged
cortege	funeral procession
cosmopolitan	worldly
coterie	close group of friends
countenance	the face; to permit
countermand	to cancel
counterpart	duplicate
coup	a brilliant move
covenant	an agreement
covert	secretive
covet	to desire
cower	to tremble
coy	shy
cozen	to trick
crafty	tricky
crass	unrefined
craven	cowardly
credence	belief
credible	believable
credulous	gullible; trusting
creed	a religious belief
crescendo	gradual increase in intensity
crestfallen	dejected
cringe	to shrink back
criterion	standard for judging
crony	close friend
crotchety	grouchy
crucible	a severe test
crux	the essential part
cryptic	mysterious
crystallize	to take on a definite form
cubicle	small compartment
cudgel	club; thick stick
cull	to pick out
culminate	to result in
culpable	worthy of blame
cumbersome	heavy or hard to handle
cumulative	accumulated
cupidity	greed
curb	to control
cursive	running or flowing
cursory	superficial
cynic	one who is critical
dais	a platform
dally	to waste time
dank	cool and wet
dappled	spotted
dastardly	cowardly or shameful
daunt	to discourage
dawdle	to waste time
dearth	a lack of
debacle	a complete failure
debase	to disgrace
debauch	to corrupt
debilitate	to weaken
debonair	charming
decadence	moral decline
decant	to pour off (a liquid)
decapitate	to behead
deciduous	not permanent
declaim	to speak dramatically
decorum	appropriate social behavior
decrepit	broken down
decry	to denounce
deduce	to reason out
deem	to believe
defamatory	damaging another's reputation
default	to fail to pay or to perform
defection	desertion
deference	respect; to show respect
defer	to postpone
defile	to corrupt
definitive	comprehensive
deflect	to turn away
defoliate	to strip off leaves
defray	to pay the cost of
deft	skillful
defunct	extinct
deify	to idolize
deign	to lower oneself
delectable	very enjoyable
deleterious	harmful
deliberate	careful or on purpose
delineate	to describe
delirium	wild excitement
delude	to deceive; to mislead
deluge	a flood
delve	to investigate
demagogue	a leader who appeals to the emotions
demeanor	behavior
demean	to degrade
demented	insane
demise	death or the end
demography	study of population
demoralize	to discourage
demure	shy
denigrate	to ruin one's reputation
denizen	inhabitant
denouement	outcome; result
denounce	to speak out against; to condemn
depict	to portray
deplete	to use up
deplore	to regret
deploy	to arrange in position
depose	to remove from office
depraved	immoral
depreciate	to reduce in value
derelict	abandoned; a vagrant
deride	to ridicule
derogatory	belittling
desecrate	to damage
desiccate	to dry up
desist	to stop
desolate	deserted
despicable	contemptible
despoil	to plunder
despot	a dictator
destitute	poor
desultory	wandering or rambling
détente	a lessening of tension
deter	to prevent; to delay or stop
detriment	harm or damage
deviate	to digress or wander from
devious	underhand
devoid	without
dexterity	skill; cleverness
diabolical	cruel
diadem	crown
dialectic	logical discussion
diaphanous	transparent
diatribe	bitter criticism
dichotomy	division into two parts
diction	style of speaking correction
dictum	a formal statement
didactic	instructive
diffident	modest
diffuse	to scatter
digress	to wander off the subject
dilate	to become wider
dilatory	slow in doing things
dilettante	one who is not an expert
diligent	hard-working
diminutive	small
din	loud noise
dint	force or power
dire	dreadful
disarray	disorder
disavow	to deny
disburse	to pay
discern	to distinguish one from another
disclaimer	denial
discomfiture	confusion
disconcert	to upset
disconsolate	without hope
discordant	harsh-sounding
discord	disagreement
discount	reduction; to disregard
discourse	lecture
discreet	cautious
discrepancy	inconsistency
discrete	separate
discretion	good judgment
discrimination	prejudice; ability to distinguish
discursive	rambling
disdain	have contempt for; strong dislike
disgruntled	unhappy
dishearten	to discourage
disheveled	untidy
disinterested	impartial
dismantle	to take apart
disparage	to belittle; to speak ill of
disparity	inequality; difference
dispassionate	calm or impartial
dispatch	done quickly and efficiently
dispel	to drive away
disreputable	having a bad reputation
dissemble	to conceal
disseminate	to spread
dissent	disagreement
dissertation	a written essay
dissident	disagreeing
dissipate	to scatter
dissociate	to break ties with
dissolute	immoral; unrestrained
dissonant	out of harmony
dissuade	to advise or urge against
distend	to expand; to smell; to stretch out
distraught	troubled
dither	confused
diurnal	daily
divergent	different; off the point
diverse	different; varied
divest	to take away
docile	obedient
document	to prove or support
doddering	senile
doff	to throw off
doggerel	comic verse or in burlesque style
dogmatic	having a definite opinion
doldrums	low spirits
doleful	sorrowful
dole	to give out sparingly
dolorous	sad
domicile	home; residence
dorsal	pertaining to the back
dossier	a complete group of documents
dotage	feeblemindedness
doughty	courageous
dour	gloomy
douse	to extinguish
dowdy	shabby
doyen	senior member
dregs	leftovers
drivel	foolish talk
droll	amusing in an odd way
drone	an idle person; to talk on monotonously
dubious	doubtful
ductile	capable of being molded
dupe	to deceive
duplicity	deceit; dishonesty
duress	force
dutiful	obedient
dynamo	a powerful person
dysphasia	difficulty in speaking
earnest	sincere or serious
earthy	realistic; coarse
ebb	to slowly decrease
ebullient	enthusiastic
eccentric	unusual; odd; weird
ecclesiastical	pertaining to the church
echelon	level of power
eclectic	choosing from various sources
eclipse	to outshine
edifice	structure; building
edify	to improve someone morally; to instruct
eerie	mysterious
efface	to wipe out
effectual	effective, adequate
effeminate	unmanly, womanly; soft and weak
effervescent	bubbly; spirited
effete	worn-out; barren
effigy	a likeness
effluent	flowing out
effrontery	shameful boldness
effusion	an uncontrolled display of emotion
egalitarian	belief in the equality of all men
egregious	very bad; outrageous
egress	exit
elaborate	to give details; complex
elapse	to pass
electrify	to thrill
elegy	a sad poem or speech
elicit	to cause to be revealed
elixir	remedy
ellipsis	the omission in a sentence of a word or words
eloquent	articulate; speaking well
elucidate	to make clear
elude	to avoid
elusive	difficult to grasp
elysian	blissful
emaciated	abnormally thin
emanate	to come forth; to send forth
emancipate	to set free
embellish	to decorate; to add details; to exaggerate
embezzle	to steal
embroil	to involve in trouble
embryo	in an early stage
emetic	causing vomiting
eminent	famous
emissary	one sent on a special mission
emit	to send out
emollient	something that soothes or softens
empathy	understanding another's feelings
empirical	based on experience rather than theory
emulate	to imitate
enamored	in love with
enclave	a country, or part of a country, surrounded by another country
encompass	to include
encore	a repeat performance
encroach	to intrude
encumbrance	hindrance or obstruction
endemic	confined to a particular area
endorse	to support
enduring	forever; lasting
enervate	to weaken
enfranchise	to give the right to vote
engender	to produce; to create
engross	completely absorbed in
engulf	to overwhelm
enhance	to increase in value or beauty; to improve
enigmatic	mysterious
enlighten	to inform
ennui	boredom
enormity	an outrageous and immoral act
enrapture	to delight beyond measure
ensconce	to hide, to conceal
ensue	to follow
enthrall	to charm
entice	to attract
entity	independent being
entourage	a group of followers
entreaty	a request; a plea
entrenched	firmly established
entrepreneur	a businessman; promoter
enunciate	to pronounce clearly
environs	surroundings
envisage	to imagine
envoy	messenger
eon	extremely long period of time
ephemeral	temporary; short-lived
epic	a long poem
epicure	one who seeks pleasure in fine foods
epigram	witty saying
epilogue	closing part of a speech or literary work
epiphany	appearance of a deity (god); revelation
epistle	a letter
epitaph	inscription on a tomb
epithet	a descriptive word or phrase
epitome	a typical example or a summary
epoch	particular period of history
equanimity	calmness, evenness of temperament
equestrian	a horseback rider
equilibrium	balanced
equine	pertaining to horses
equinox	the time when day and night are of equal length
equivocal	doubtful
eradicate	to wipe out
erode	to wear away
erotic	pertaining to sexual love
erratic	irregular; without direction
erroneous	mistaken
err	to make a mistake
ersatz	inferior substitute
erstwhile	in the past
erudite	scholarly
escalate	to grow rapidly
escapade	a reckless adventure
escarpment	steep cliff
eschew	to avoid
esoteric	known only to a few
espouse	to support
essay	to try
esteem	high regard
estival	pertaining to summer
estranged	separated
ethereal	spiritual
ethnic	pertaining to a particular race
etymology	the origin and development of words
eugenics	science of improving the human race
euphemism	substitution of one expression for another
euphonious	having a pleasant sound
euphoria	a feeling of well-being
euthanasia	mercy killing
evanescent	temporary, fleeting
eventuate	to happen
evince	to show clearly
evoke	to produce
exacerbate	to aggravate
exact	accurate; to require
exasperate	to irritate or to annoy
excise	to cut out or off
excruciating	unbearably painful
exculpate	to free from blame
execrate	to curse
exemplary	worthy of imitation; outstanding
exemplify	to make an example of
exhaustive	thorough; complete
exhilaration	liveliness
exhort	to warn or urge
exhume	to bring out of the ground
exigent	urgent
exodus	a going out
exonerate	to free from guilt or blame
exorcise	to drive out an evil spirit
exotic	foreign; strange
expatiate	to enlarge upon
expatriate	a person who leaves his native country
expedient	practical
expedite	to make easy, to make faster
expiate	to atone for
explicate	make clear
expound	to explain
expunge	to erase
expurgate	to remove
extant	still in existence or stand above
extemporaneous	done without preparation
extenuating	less serious
extirpate	to destroy
extol	to praise
extort	to obtain by force
extraneous	not essential
extrapolate	to estimate; to infer
extricate	to set free; to disentangle
extrinsic	external; coming from outside
extrovert	an outgoing person
exuberant	full of enthusiasm
exude	to spread out or to give off
exult	to rejoice
fabricate	to construct or to lie
facade	outward appearance
facet	aspect
facetious	sarcastic
facile	easy
facilitate	to make easy
facsimile	a duplicate
faction	a minority within a larger group
factious	causing disagreement
factitious	artificial
faculty	ability or skill
fallacious	misleading; false; untrue
fallible	capable of error
fallow	inactive
falter	to stumble
fanatic	a person with uncontrolled devotion
fanciful	imaginative
farcical	absurd; ridiculous
fastidious	hard to please
fatalistic	believing that all things in life are inevitable
fathom	nautical measure; to understand
fatuous	foolish
fauna	animals of a certain area
fawn	excessively flattering manner
faze	to disturb
fealty	loyalty; devotion
feasible	capable of being achieved
feat	accomplishment
fecundity	fertile; productive
feign	to pretend
feint	a false show or a pretended act
felicity	happiness
feline	pertaining to cats
fell	to knock down; cruel
felonious	harmful
ferment	a state of agitation
ferret	to search or drive out
fervent	eager; passionate
fervid	very emotional; enthusiastic
fester	to rot
festive	joyous
fete	to entertain
fetid	foul-smelling
fetish	object that receives respect
fetter	to confine
fiasco	a total disaster
fiat	an official order
fickle	changeable or unfaithful
fictitious	false
fidelity	faithfulness
figment	something imagined
filch	to steal
filial	like a son or daughter
finesse	tact
finite	limited
firebrand	one who stirs up trouble
firmament	strength or pertaining to the heavens
fiscal	pertaining to finances
fissure	opening or split
fitful	irregular
flabbergasted	astonished
flaccid	flabby
flag	a banner; to slow down
flagellate	to whip
flagrant	shocking; bad
flail	to strike wildly
flair	a knack; a natural talent
flamboyant	showy; conspicuous
flaunt	to show off
flay	to strip off; to criticize sharply
fledgling	a young, inexperienced person
fleece	to swindle
flinch	to cringe
flippant	treating serious matters lightly
flora	plant life in a certain ares
florid	flowery; ornate
flotilla	fleet of ships
flotsam	floating wreckage
flourish	a dramatic
flout	to ridicule
fluctuate	to vary
fluent	able to speak and/or write clearly
fluster	to confuse
fluvial	pertaining to a river
flux	state of continual change
foible	minor fault
foil	to prevent the success of a plan
foist	to pass off something which is inferior
foment	to stir up
fop	excessively vain; foolish
foray	a sudden attack
forbearance	patience
foreboding	a warning
forensic	pertaining to a formal debate
forerunner	ancestor
foreshadow	to hint
forestall	to prevent by acting in advance
forgo	to give up
forte	strong point
forthright	direct
fortnight	two weeks
fortuitous	lucky; happening by chance
foster	to encourage
fracas	brawl; uproar
fractious	quarrelsome
franchise	special privilege
fraternal	brotherly
fraught	filled with
fray	quarrel; unravel
frenetic	frantic
frenzy	fury
freshet	a fresh water stream
fretful	worried
friction	a rubbing together; conflict or disagreement
frivolous	silly or unimportant
frowzy	unkempt
frugal	thrifty
fruition	fulfillment
fruitless	having no results
frustrate	to prevent, to discourage
fulminate	to explode; to denounce
fulsome	disgusting
fundamental	essential; basic
furor	rage
furtive	stealthy; secretive
fusion	merging
futile	hopeless; useless; worthless
gadfly	a person who annoys others
gaff	a hook
gainsay	to contradict
gait	manner of walking
gala	festive
gallant	noble
galvanize	to stimulate
gambit	strategy
gambol	to romp about
gamut	the whole range
gape	to stare with open mouth
garble	to distort
gargantuan	gigantic
garish	gaudy
garland	a wreath of flowers
garner	to acquire
garnish	to decorate
garrulous	talkative
gauche	tactless
gaudy	flashy
gaunt	thin and bony
gazette	newspaper
gelid	very cold
generate	to produce
generic	general; not specific
genesis	origin
genial	friendly
genocide	killing of a race of people
genre	type of art or literature
genteel	polite
gentry	upper class
genuflect	to kneel
germane	relevant
gerontology	the study of older people
gesticulation	lively gestures
ghastly	horrible
gibberish	silly talk
gibbet	gallows from which criminals are hanged
gibe	to ridicule
giddy	dizzy or light-headed
gild	to cover with gold
gingerly	carefully
gird	to encircle
gist	main point
glazed	smooth
glean	to gather with great effort
glee	happiness
glib	smooth
glitch	a malfunction
gloaming	twilight
gloat	to dwell on with great satisfaction
glower	to frown
glutinous	sticky
gnarled	twisted
gnome	a legendary creature
goad	to encourage; to spur on
gorge	a deep valley; to eat greedily
gossamer	light; flimsy; fine
gothic	medieval; mysterious
gouge	to dig out; to swindle or overcharge
gourmand	a glutton
gourmet	an expert of food and drink
gradient	a slope
grandiose	impressive; showy
graphic	giving a clear and effective picture
grapple	to grip and hold; to struggle
grate	to irritate
gratis	free
gratuitous	free
grave	serious
gravity	importance or weight; seriousness
gregarious	friendly
grievous	very distressing
grimace	an expression of disapproval
grim	fierce or harsh
grisly	horrible; gruesome; ghastly
grit	courage
gross	extreme or vulgar
grotesque	distorted
grotto	a cave
grovel	to lower oneself
gruff	rough or harsh manner
guile	deceit; trickery; cunning
guise	a false appearance
gullible	easily deceived
gull	to trick
gumption	courage and initiative
gustatory	pertaining to the sense of taste
guttural	unpleasant sound
gyrate	to spin
habitat	dwelling
habit	usual behavior or addiction
hackneyed	overused; banal
haggard	worn out
haggle	to bargain over
halcyon	calm
hale	healthy
hallmark	a symbol of high quality
hallow	to make holy
hamper	to hinder
haphazard	dependent upon chance
hapless	unlucky
harangue	long speech
harass	to annoy
harbinger	an omen
harbor	to conceal
hardy	sturdy or strong
harpy	a greedy, nagging person
harrowing	distressing
harry	to worry
haughty	arrogant
haunt	to disturb
haven	a safe place
havoc	destruction
headlong	recklessly
headstrong	stubborn
hearsay	rumor
hearth	fireplace
hector	to bully
hedonist	a pleasure-seeker; self indulgent
heedless	careless
heed	obey
hegemony	strong influence
heinous	hateful or shocking
hemophilia	tendency toward bleeding
herald	to announce
herbivorous	feeding on plants
herculean	tremendous in size
heresy	to strongly oppose a belief
hermetic	airtight
heterogeneous	different
hiatus	pause or rest
hierarchy	a ranking
hilarity	joy
hinder	to block; to obstruct
hirsute	hairy; bearded
histrionic	overly dramatic
hoard	to accumulate secretly
hoary	white with age
hoax	a joke
hodgepodge	mixture
holocaust	total destruction
homage	honor
homily	a sermon
homogeneous	all of the same kind
homophonic	sounding alike
hone	to sharpen
hoodwink	to deceive
horde	a crowd
horticulture	the science of gardening
hospice	shelter
hovel	a dirty, wretched living place
hover	to linger about; to wait near
hubris	excessive pride or self-confidence
hue	a color
humbug	a trick
humdrum	boring or routine
humility	meekness
humus	black soil for fertilizing
hurtle	to speed
hybrid	mixed; assorted
hydrophobia	fear of water
hyperbole	extreme exaggeration
hypochondriac	a person with imaginary illnesses
hypocrite	one who pretends to be something he is not
hypocritical	insincere; two-faced
hypothesis	an assumption
hypothetical	theoretical; suppositive
icon	a statue
iconoclast	one who breaks with tradition
idealist	one with very high principles
idiomatic	language particular to a group
idiosyncrasy	a peculiar trait
idolatry	worship of idols
idyllic	charmingly simple or poetic
igneous	pertaining to fire
ignoble	dishonorable
ignominious	shameful; disgraceful
ilk	type; sort; kind
illicit	unlawful; illegal
illiterate	uneducated
illuminate	to make clear; light up
illumine	to brighten, to inspire
illusory	misleading impression
illustrious	distinguished; bright
imbibe	to drink; to absorb
imbroglio	a difficult or confusing situation
imbue	to fill completely
immaculate	spotless; pure
imminent	likely to happen; threatening
immolate	to kill someone as a sacrificial victim, usually by fire
immortal	not subject to death
immunity	freedom from disease; protected
immutable	unchangeable
impair	to weaken, to cause to become worse
impale	to pierce with a sharp stake through the body
impalpable	vague; not understandable
impartial	without prejudice; neutral
impasse	a dead-end; a problem without a solution
impeach	to accuse
impeccable	perfect
impecunious	without money
impede	to block
impediment	an obstruction
impel	push into action
impending	likely to happen soon
imperative	very necessary
imperious	domineering
impermeable	not permitting passage
impertinent	rude
imperturbable	calm
impervious	not capable of being affected
impetuous	impulsive
impetus	a stimulus
impinge	to collide
implacable	inflexible
implausible	unbelievable
implement	a tool; to carry off
implication	an indirect suggestion
implicit	suggested, but not plainly stated
import	significance; to bring in from a foreign country
importune	to beg
impotent	powerless
imprecaton	a curse
impregnable	unconquerable
impromptu	without planning
impropriety	pertaining to something that is not proper or suitable
improvident	wasteful
impudent	disrespectful
impugn	to attack a person verbally
impunity	freedom from punishment
impute	to accuse a person
inadvertent	unintentional
inalienable	not able to be given to another
inane	meaningless
inanimate	lifeless dull, dead
inarticulate	unclear speech
incandescent	very bright
incapacitated	disabled
incarcerate	to imprison
incarnadine	blood-red; flesh-colored
incarnate	in human form
incendiary	causing fire or trouble
incense	to anger
inception	start
incessant	continuous; never ending
inchoate	just beginning
incipient	beginning to appear
incisive	sharp or keen perception
incite	to stir up
inclement	(usually refers to weather) harsh; unfavorable; severe
inclined	favorable to one direction
incognito	disguised
incoherent	rambling; not logically connected
incongruous	not appropriate; out of place
inconsequential	unimportant
incontrovertible	undeniable
incorrigible	bad beyond correction
increment	an increase
incriminate	to connect to a crime
incubus	nightmare
inculcate	to influence someone to accept an idea
incumbent	resting or lying; one who holds a political office
incursion	a raid
incur	to bring upon oneself
indefatigable	untiring
indelible	incapable of being erased
indemnify	to repay for a loss
indicative	signifying; implying
indict	to charge with a crime; to accuse of a wrongdoing
indifferent	neutral; lacking preference
indigenous	native to a particular area; inborn
indigent	extremely poor
indignant	angry as a result of unjust treatment
indiscriminate	at random
indoctrinate	to teach someone a set of beliefs
indolence	laziness
indomitable	unconquerable
indubitable	unquestionable
induce	to bring about
indulgence	gentle treatment; pampering
inebriated	drunk
ineffable	unspeakable
ineluctable	inevitable
inept	unfit
inert	not moving
inevitable	unavoidable; will happen
inexorable	unyielding
infallible	without mistakes
infamous	notorious; scandalous
infamy	shocking or brutal
infantile	immature
infernal	fiendish
infer	to derive by reasoning; imply
infidel	unbeliever
infinitesimal	very small
infirmity	weakness; feebleness
influx	a flowing in
infraction	the breaking of a law
infringe	to violate
ingenious	clever
ingenuous	simple; innocent
ingrate	ungrateful person
ingratiate	to work one's way into another's favor
inherent	inborn
inhibition	reserved
inimical	unfriendly
inimitable	not able to be imitated or unequaled
iniquity	wickedness
injunction	an order
inkling	a hint
innate	inborn
innocuous	harmless
innovate	to be creative; begin anew
innuendo	indirect remark
inordinate	excessive
insatiable	unable to be satisfied
inscrutable	mysterious
insidious	treacherous
insightful	having a penetrating understanding of things; mentally alert and sharp
insinuate	to hint; to suggest
insipid	tasteless; bland; boring
insolent	boldly disrespectful
insolvent	bankrupt; unable to pay creditors
insouciant	carefree
instigate	to stir up (trouble)
insular	detached or isolated
insuperable	unconquerable
insurgence	rebellion
insurrection	uprising
intact	left whole
intangible	vague or untouchable; abstract
integral	essential
integrate	unify; to bring together
integrity	honesty
interdict	to prohibit; to block
interim	period of time between acts
interlocutor	one who takes part in a conversation
interloper	an intruder
interlude	a period of time between two events
interminable	endless
intermittent	periodic
interpose	to place between
interregnum	period during which a nation is without a permanent leader; pause
inter	to bury
intimate	private; to imply
intimidate	threaten
intolerant	bigoted
intractable	hard to manage
intransigent	stubborn
intrepid	courageous
intrinsic	essential
introspective	looking into oneself
intuitive	insightful
inundate	to fill to overflowing
inured	accustomed to
invalidate	make null and void
invariably	constantly; without changing
invective	strong verbal abuse
inveigh	a bitter verbal attack
inveigle	trick or deceive
inveterate	firmly established; deep-rooted
invidious	causing resentment; offensive
invigorate	to fill with energy
invoke	to call upon
iota	a small amount
irascible	easily angered
ire	anger; wrath
iridescent	a wide range of colors
irksome	annoying
ironic	unexpected
irrational	unreasonable; unpredictable
irreconcilable	unable to agree
irredeemable	hopeless
irremediable	unable to be changed or cured
irrepressible	unable to be restrained
irresolute	doubtful
irreverent	disrespectful
irrevocable	unchangeable
itinerant	moving from place to place
jaded	tired; worn out
jargon	vocabulary of a particular group of people
jaundiced	yellowed skin or prejudiced
jaunt	short trip
jaunty	carefree
jeer	to sneer; to mock
jeopardy	danger
jilt	to reject
jingoist	extreme patriotism, favoring warlike actions
jocose	happy; lively
jocular	humorous
jostle	to bump
judicious	wise; sound judgment
juggernaut	a destructive force
jugular	pertaining to the throat or neck
juncture	a point of time
junket	a pleasure trip
junta	a small group ruling a country
jurisprudence	study of law
jut	to stick out
juxtapose	to place side by side
kaleidoscopic	changing
ken	range of knowledge
kindle	to excite or start
kindred	relatives or shared feeling or views
kinetic	pertaining to motion
kismet	destiny
kleptomania	a compulsion to steal
knave	deceitful person
knead	to work something into a mixture
knell	the sound made by a bell rung slowly
knoll	a small hill
knuckle	to yield; to work vigorously
labyrinth	complicated
lacerate	to tear roughly
lachrymose	tearful
lackadaisical	uninterested
lackey	slavish follower
lackluster	lacking brilliance; dull
laconic	concise
lactic	pertaining to milk
laggard	a slow person
laity	religious followers
lambent	radiant; to move lightly over a surface
lament	to mourn
laminated	covered with thin sheets of plastic
lampoon	sharp satire
languid	sluggish
lanky	tall and slender
lapidary	a dealer in precious stones
larceny	theft
largess	a generous gift
lascivious	lustful
lassitude	weakness and weariness
latent	present, but not visible
lateral	sideways
latitude	freedom
laudable	praiseworthy
laureate	worthy of honor
lave	to wash
lax	negligent; careless
leeway	room for action
legerdemain	deception
lenient	permissive
leonine	fierce
lesion	a wound
lethargic	dull or sluggish; weak
leviathan	anything huge
levity	lack of seriousness; humor
levy	to impose taxes
lexicon	dictionary or vocabulary of a special group
liaison	a bond or a connection
libation	a drink
libel	a false, written statement
liberal	generous
libertine	immoral person
licentious	lawless or immoral
liege	lord; master
lieu (in lieu of)	in place of; instead of
lilliputian	very small
limber	easily bent
lineage	ancestry
lineaments	facial features
linguist	skilled in languages
lionize	to treat as important
liquidate	to get rid of
lissome	moving gracefully
listless	indifferent
literal	word for word
lithe	graceful
litigation	lawsuit
livid	discolored from anger or embarrassment
loathe	to hate or feel disgust for
loath	unwilling
locus	place
logistics	the supply, movement, and maintenance of equipment
loiter	to hang around
loll	to lounge about or to droop
loquacious	very talkative
lot	fate
lout	an awkward, stupid person
lowly	humble or ordinary
lucent	shining
lucid	easy to understand
lucrative	profitable
ludicrous	ridiculous
lugubrious	mournful
luminous	bright
lupine	fierce
lurch	sudden, forward movement
lurid	shocking
lurk	to lie concealed or to stay hidden
lush	abundant
macabre	gruesome
machination	evil design
macroscopic	visible to the naked eye
maelstrom	whirlpool
magnanimous	generous
magnate	important person
maim	to cripple
maladroit	clumsy or unskillful
malady	disease
malaise	uneasiness
malapropism	word humorously misused
malediction	curse
malefactor	villain
malevolent	harmful
malfeasance	wrongdoing
malicious	spiteful
malignant	evil
malign	to speak badly about
malingerer	one who pretends to be ill to avoid work
malleable	adaptable
manacle	handcuff
mandarin	influential person
mandate	an order
manifest	obvious
manifold	many
manipulate	to handle with skill; to influence a person
manumit	to set free
maraud	to raid
maritime	pertaining to the ocean
marquee	a canopy over an entrance
marred	damaged; ruined
martial	warlike
martinet	a strict disciplinarian
masochist	one who enjoys his own pain
masticate	to chew
matriarchy	a society in which the mother is the head of the family
matrix	a place of origin
maudlin	very sentimental
maul	to injure
mausoleum	large tomb
maverick	a nonconformist
mawkish	overly sentimental
maxim	a proverb or saying
meager	inadequate, of poor quality
meander	to wander aimlessly
mean	nasty or offensive; inferior or low; an average
mediate	to settle a dispute
medicant	a beggar
meditate	to think deeply
medley	a mixture
megalomania	exaggeration of one's own greatness
melancholy	depressed
melee	noisy fight
mellifluous	sweet-sounding
melodramatic	overly emotional
menace	a threat
ménage	household
menagerie	collection of animals
mendacious	lying
menial	degrading
mentor	adviser or coach
mercantile	pertaining to merchants
mercenary	acts only for money
mercurial	unpredictably
meretricious	gaudy or showy
merger	a joining together
mesmerize	hypnotize
metamorphosis	a transformation
metaphor	comparison
metaphysics	beyond what is natural
meteoric	swift rise
mete	to distribute
meticulous	extremely careful
metropolis	large city
mettle	courage
miasma	pollution
microcosm	a little world
mien	manner
milieu	environment, setting
militant	ready and willing to fight
millennium	a thousand years
mimic	to imitate
minion	a devoted follower
minute	unit of time or small and insignificant
mire	swampy ground; to sink down
mirth	joy or laughter
misanthrope	hater of mankind
misapprehension	a misunderstanding
miscegenation	mixture of races
mischance	unlucky accident; bad luck
misconstrue	misinterpret
miscreant	a vicious person
misdemeanor	a less serious crime
miser	one who hoards (money) excessively
misgiving	doubt; suspicion
misnomer	an error in name
misogamy	hatred of marriage
misogynist	woman-hater
missive	letter
mitigate	to make less severe
mnemonic	pertaining to memory
mock	to ridicule or insult
modish	stylish
modulate	to tone down
mogul	powerful person
mollify	to calm or appease
molt	to shed
momentous	very important
monarchy	one ruler
monastic	self-denying
monitor	one who watches
monograph	written about a single subject
monolithic	unified or solid
monologue	speech by one person
monotheism	belief in one god
monotonous	boring; without variety
monumental	important
moot	debatable or having no significance
moratorium	delay
morbid	depressing
mordant	sarcastic
mores	customs or traditions
moribund	dying
morose	gloomy
mortal	destined to die
mortify	to embarrass or humiliate
motif	central ides
motley	assorted or different colors
mottled	spotted
mountebank	a fraud
muddle	to confuse
mulct	a fine or to defraud
mull (over)	think about
multifarious	having many parts
mundane	worldly
munificent	generous
murky	unclear; gloomy
muse	to think deeply
muster	to gather together
musty	stale; moldy
mute	silent
muzzle	to restrain
myopic	having narrow point of view
myriad	infinitely vast in number
myrmidon	an unquestioning follower
nabob	a very wealthy or powerful person
nadir	lowest point
naive	unsophisticated
narcissistic	vain
nascent	coming into being
natation	the act of swimming
nativity	birth
nebulous	vague
necromancy	magic
nefarious	evil
negate	to deny, to nullify
negligent	careless; neglectful
nemesis	victorious rival
neologism	new use of a word
neophyte	a beginner
nepotism	favoritism shown toward relatives
nether	lower or under
nettle	to irritate
neutralize	to make ineffective
nexus	connection or link
nicety	dainty or delicate
niche	recess in a wall or best place for a person
niggardly	stingy
niggle	petty
nihilism	total rejection of law
nimble	quick
nirvana	place of great happiness
nocturnal	pertaining to night
nodule	a small lamp
noisome	harmful or offensive
nomadic	wandering
nomenclature	a set of terms
nominal	in name only, unimportant
nonage	immaturity
nonchalant	casual
noncommittal	no definite point of view
nonentity	person of little importance
nonpareil	unequaled
nonplus	to confuse
non sequitur	something that is not logical
nostalgic	longing for the past
nostrum	questionable medicine
notorious	having a bad reputation
novel	new; unusual
novice	a beginner
noxious	harmful to health
nuance	small variation in meaning or color
nub	a small piece
nugatory	worthless
nullify	to make useless
numismatist	coin collector
nuptial	pertain to marriage
nurture	to nourish; to sustain
nutriment	nourishment
oaf	a dunce
obdurate	stubborn
obeisance	gesture expressing deep respect
obfuscate	to confuse
objective	unbiased
oblation	an offering
obligatory	required
oblique	indirect
oblivious	unmindful; unaware
obloquy	bad reputation resulting from public disgrace
obscure	not clear; partially hidden
obsequious	submissive or overly attentive
obsequy	a funeral rite
obsess	to control the thoughts or feelings of a person
obstinate	stubborn
obstreperous	loud and unruly
obtrude	to push something toward or upon a person
obtuse	slow to understand
obviate	to prevent
occidental	western
occlude	to close; to block out
occult	secret or mysterious
ocular	pertaining to sight
odious	disgusting
odoriferous	giving off a pleasant smell
odyssey	a long journey
offal	garbage
officious	interfering
ogle	to look at with desire
ogre	monster
olfactory	pertaining to smell
oligarchy	government by only a few
omen	a sign which indicates the future
ominous	threatening
omnifarious	of all kinds
omnipotent	all-powerful
omniscient	all-knowing
omnivorous	eating anything; absorbing everything
onerous	burdensome
onslaught	a furious attack
onus	a burden
opaque	not transparent; not letting light pass through
opiate	narcotic; causing sleep
opprobrious	shameful
optimist	one who sees the good side of things
optimum	the best; most favorable
opt	to choose
opulent	rich; luxurious
oracular	mysterious
oration	a speech
orbit	a path around an object
ordain	to order or establish
ordinance	a law
organic	fundamental or essential
orient	an area of the Far East; to adjust
orifice	opening
ornate	showy
ornithology	study of birds
orthodox	accepting traditional beliefs; conventional
oscillate	to swing or move back and forth
ossify	to change into bone or become rigid
ostensible	apparent
ostentatious	showing off
ostracize	to banish
overt	open not hidden
ovine	like a sheep
ovoid	egg-shaped
pacify	to calm down
pact	an agreement
paean	song of joy
palatable	pleasant to taste
palatial	magnificent
paleontology	study of prehistoric life
palliate	to lesson
pallid	pale; cull
pall	something that covers or to be unpleasant
palpable	capable of being touched
palpitate	to beat rapidly
palsy	muscle paralysis
paltry	worthless; small
panacea	an answer for all problems
panache	a showy manner
pandemonium	confusion
panegyric	an expression of praise
pang	a sharp pain
panoply	suit of armor; any protective covering
panorama	unlimited views; comprehensive survey
parable	a simple story giving a moral or religious lesson
paradigm	a model; an example
paradox	a statement that is contradictory, but probably true
paragon	a model of perfection
paramount	supreme
paraphernalia	equipment
parched	extremely thirsty
pariah	an outcast
parley	a conference
parochial	limited or related to a church
parody	a work which imitates another in a satirical way
paroxysm	a sudden outburst
parrot	to repeat or imitate
parry	to avoid something such as a blow; to evade
parsimonious	stingy
partisan	a strong supporter
passè	out-of-date
passive	submissive
pastoral	pertaining to the country
patent	government protection for an invention; obvious
paternal	fatherly
pathogenic	causing disease
pathos	deep feeling of pity
patriarch	a person regarded as a founder or father
patrician	aristocratic
patrimony	inherited right
patronage	the power to make appointments to government jobs
patronize	to be a customer or to talk down to
paucity	scarcity; lack of
peccadillo	a minor offense
pectoral	pertaining to the chest
peculate	to steal
pecuniary	pertaining to money
pedagogue	a schoolteacher
pedantic	to show off one's knowledge
pedestrian	ordinary; common; banal
pedigree	a record of ancestors
peer	an equal or to look at closely
peerless	without equal
peevish	hard to please
pejorative	insulting
pellucid	transparent
pelt	skin of an animal; to throw
penal	pertaining to punishment
penchant	a strong liking for
penitent	expressing sorrow for a wrongdoing
pensive	thoughtful
penury	extreme poverty
peon	common worker
perceive	to observe or understand
perceptible	recognizable
perceptive	quick witted; keen
perdition	damnation
peregrinate	to travel; journey
peremptory	decisive or final
perennial	lasting for a long time; perpetual
perfidious	deceitful; unfaithful
perforce	of necessity
perfunctory	routine
perigee	point nearest to the earth
periphery	outside boundary; unimportant area of a subject
permeate	to spread throughout
pernicious	destructive
peroration	the concluding part of a speech
perpetrate	to be guilty of
perpetuate	cause to continue
perplex	confuse
perquisite	something additional to regular pay
persevere	to endure
personification	giving human qualities to a non-human being or to abstract ideas
perspicacity	sharp insight
perspicuity	clearness
pert	bold; lively
pertinent	to the point
perturb	to disturb
peruse	to read carefully
pervade	to spread throughout
perverse	contrary; stubborn
pervert	to corrupt
pessimist	one who sees the worst
petrify	to paralyze with fear
petrology	study of rocks
petty	unimportant
petulant	irritable
phalanx	compact group of people
phenomenon	extraordinary (fact or occurrence)
philander	to engage in many love affairs
philanthropy	generosity to mankind
philately	stamp collecting
philippic	a verbal attack
philistine	uncultured
phlegmatic	unemotional
phobia	intense fear
phoenix	a bird symbolizing immortality
picaresque	adventurous scoundrel
piddling	petty
piecemeal	bit by bit
pied	many-colored; variegated
piety	devotion
pigment	dye
pilgrimage	a journey to a holy place
pillage	to loot
pillory	to expose to public ridicule
pinnacle	highest point
pious	religious; deeply devoted to religion
piquant	stimulating to the taste; exciting
pique	to irritate
piscine	of or like a fish
pithy	to the point
pittance	small amount
pivotal	crucial; critical; important
placard	small poster
placate	to calm
placebo	harmless, phony medicine
placid	calm
plague	a contagious disease; to trouble
plaintive	sorrowful
platitude	a dull or trite remark
platonic	spiritual; free from sensual desire
plaudit	applause; any expression of approval
plausible	apparently true; reasonable
plebeian	pertaining to the lower classes
plenary	complete or absolute
plethora	abundance
pliant	easily bent
plight	a sad situation
ploy	a trick
pluck	to pull at; courage
plumb	to measure
plutocracy	rule by the wealthy class
poach	hunt or fish illegally
podium	a platform
poignant	distressing; affecting the emotions
polarize	to separate into opposing groups
polemic	a controversy
politic	diplomatic
poltroon	a coward
polychromatic	many-colored
polyglot	speaking or writing several languages
polymorphic	having many forms
polytheism	belief in many gods
pomp	show or display
ponderous	heavy
ponder	to think deeply
porcine	like a pig
portable	capable of being carried
portal	door or entrance
portentous	warning
portly	large
posterity	future generations
posthumous	after death
postulate	to assume
potable	drinkable
potentate	ruler
potential	capacity or ability
potent	powerful
potion	a drink
potpourri	a mixture
pragmatic	practical
prate	to talk long and pointlessly
precarious	uncertain or risky
precedent	an act used as example
precept	a rule of conduct
precipice	cliff
precipitate	to bring about an action
precipitous	extremely steep
précis	brief summary
preclude	to shut out; prevent
precocious	prematurely developed
precursor	a forerunner
predecessor	one who comes before another
predicate	to declare
predilection	a liking; preference; inclination
predispose	inclined in advance
preeminent	standing out above all others
preen	to dress
prehensile	adapted for grasping something
premeditate	to plan beforehand
premier	first in importance
premise	statement made as a basis of an argument
premonition	forewarning
preponderance	superiority in quantity; dominance
preposterous	ridiculous
prerogative	privilege
presage	to indicate or warn in advance
prescience	knowledge of things before they happen
presentiment	anticipation, especially of something evil
prestige	importance
presumptuous	boldly assuming
pretentious	showy; self-important; pompous
preternatural	abnormal
pretext	a false reason
prevail	to succeed
prevaricate	to lie
primeval	of the earliest times
prim	formal; proper
primogeniture	state of being the first born
primordial	original
primp	to dress up in a fussy way
prismatic	many-colored
pristine	uncorrupted; in its original state
privation	loss of something essential
privy	having knowledge of something private
probe	to investigate or examine
probity	honesty
proclivity	tendency
procrastinate	to postpone
procreate	to produce
procrustean	to get conformity at any cost
procure	to obtain
prodigal	wasteful
prodigious	enormous; great amount
profane	showing disrespect
profess	to acknowledge or admit
proffer	to offer
proficiency	skill; ability
profligate	immoral or extremely wasteful
profound	very deep; insightful
profuse	abundant
progeny	descendants
prognosticate	to predict; to foretell
proletarian	a member of the working class
proliferate	to increase or expand
prolific	productive
prolix	tediously long and wordy
prologue	introduction
promenade	a stroll or a walk an area used for walking
promiscuous	sexually loose
promontory	piece of land that juts out
promulgate	to advocate
prone	lying flat
propagate	to multiply
propensity	inclination
prophetic	predicting
propinquity	closeness
propitious	favorable
propriety	conformity; appropriateness
prosaic	commonplace or dull
proscribe	to denounce; exile
proselyte	a convert
prospectus	a report describing a new project
prostrate	lying flat
protagonist	main character
protean	changeable
protégé	one who has been instructed by another
protocol	etiquette observed by diplomats
prototype	the original
protract	to prolong
protrude	to stick out
proverbial	well-known
provident	having foresight; prudent
provincial	unsophisticated; narrow; limited
provisional	temporary
proviso	a condition
provoke	to irritate; to excite
prowess	skill or strength
proximity	nearness
proxy	one who acts in place of another
prudence	good judgment; cautious; careful
prune	to cut off or lop off such as twigs, branches. or roots
prurient	lustful; obscene; lewd
pseudo	false
pseudonym	an assumed name
psyche	the human spirit
puerile	immature
pugilist	a boxer
pugnacious	eager to fight
puissant	powerful
pulchritude	beauty
pulmonary	pertaining to the lungs
pulverize	crush or grind; totally destroy
pummel	to beat or thrash with the fists
punctilious	precise
pundit	an expert
pungent	having a sharp taste or smell; severely critical or sarcastic
punitive	pertaining to punishment
pun	the use of words that sound alike but differ in meaning
puny	weak
purge	to purify
puritanical	strict
purloin	to steal
purport	to claim
purvey	to supply
pusillanimous	cowardly
putative	supposed; believed
putrefy	to decay
pyre	a funeral fire
pyretic	pertaining to fever
pyromaniac	one who likes to start fires
quadruped	a four-footed animal
quaff	to gulp; to drink in large quantities
quagmire	a swamp; a difficult situation
quail	to lose courage
quaint	pleasing or amusing
qualm	a feeling of uneasiness
quandary	a puzzling situation
quarry	being hunted
quash	to cancel
quasi	resembling
quaver	to tremble
quay	a wharf
queasy	uneasy
quell	to calm down
querulous	complaining
query	a question
quest	a search
queue	a line of people
quibble	petty argument
quiddity	essential quality
quidnunc	a gossip
quiescent	motionless
quietus	finishing stroke; anything that ends an activity
quintessence	essence of something
quip	a witty remark
quirk	a peculiar characteristic; a sudden twist or turn
quiver	to tremble
quixotic	extremely idealistic
quizzical	questioning or puzzled
quotidian	daily
rabble	disorderly crowd
rabid	intense or mad
rack	to torture
raconteur	storyteller
radical	extreme; complete; violent
rail	to complain bitterly
raiment	clothing
rakish	carefree
rambunctious	hard to control
ramification	a result or a consequence
rampant	widespread
rancid	a bad taste or smell; stale
rancor	hatred
rankle	to irritate
rant	to speak in a loud manner
rapacious	taking by force
rapport	harmony
rapt	completely absorbed in or overcome with joy
rarefy	to make less dense; to refine
rash	a skin irritation; reckless
raspy	harsh; grating
ratify	to approve of
ratiocinate	to reason
ration	a fixed portion
rationalize	to make an excuse for
rational	reasonable
raucous	irritating or harsh sound
ravenous	extremely hungry; greedy
raze	to destroy
realm	kingdom or region
rebuff	to reject to snub
rebuke	to scold
rebuttal	opposing argument
recalcitrant	hard to manage
recant	to withdraw a statement
recapitulate	to summarize
recede	to withdraw
recess	a notch in something or a pause or rest
recidivism	to return to criminal behavior
reciprocal	interchangeable
reciprocate	to give in return
recluse	hermit
reconcile	to bring into agreement or harmony
recondite	hard to understand
reconnoiter	to survey
recount	to tell a story
recreant	coward
recrimination	countercharge
rectify	to correct
rectitude	honest
recumbent	reclining
recuperate	to recover
redemption	deliverance or rescue
redolent	having a pleasant odor
redoubtable	formidable
redress	to remedy
redundant	superfluous; unnecessary; repetitive
refractory	stubborn
refulgent	shining; glowing
refurbish	to make new
refute	to prove wrong; disprove
regale	to entertain
regal	pertaining to a ruler; splendid
regenerate	to re-create; to reform morally; to replace a lost part of the body
regent	one who governs
regicide	the killing of a king
regime	a system of government
regimen	a regular routine
regurgitate	to bring back
rehabilitate	to restore
reimburse	to pay back
reiterate	to repeat
rejuvenate	to make new or young again
relegate	to give an inferior position to
relentless	unyielding
relevant	pertaining to the subject
relinquish	to give up
relish	to enjoy
remediable	capable of being corrected
remedial	intended to correct
reminisce	to remember
remission	a lessening; a forgiveness of offenses
remiss	negligent
remonstrate	to protest; to complain
remorse	regret; sadness
remunerate	payment for a service
renaissance	rebirth; renewal; revival
rendezvous	a meeting; appointment
rend	to split; to tear apart
renegade	traitor or outlaw
renege	to go back on one's word
reparation	compensation; to make up for a wrong
repartee	a witty reply
repast	a meal
repercussion	after-effect
repertoire	special skills or talents
repine	to complain; to fret
replete	filled
repose	to rest
reprehensible	shameful
repress	to control; to hold down
reprimand	to scold
reprisal	revenge
reproach	to blame
reprobate	a wicked person
reproof	a rebuke
repudiate	to reject
repugnant	disgusting
repulse	to drive back
reputed	supposed to be
requiem	funeral hymn
requisite	required or necessary
requite	to return or avenge
rescind	to cancel; to repeal
resignation	acceptance of a situation or circumstance
resilient	recovering quickly
resolute	very determined
resolve	solve a problem; strong determination
resonance	fullness of sound
respite	a rest
resplendent	shining brightly
restitution	repayment
restive	restless or impatient
résumé	a summary
resurge	to rise again
resurrection	revival
resuscitate	to revive
retaliation	revenge
retentive	having a good memory
reticent	silent or reserved
retinue	group of followers
retort	a short, witty reply
retract	to take back
retrench	to cut back or reduce
retribution	punishment
retroactive	applying to a period before a certain act was passed
retrogressive	going backwards
revelation	something made known
revelry	merrymaking
reverberate	to echo
revere	to respect; to honor
reverie	a daydream
revile	to abuse; to slander
rhetorical	concerned with style not content
ribald	vulgar; indecent
rife	frequently occurring
rift	a break or spilt
rigorous	strict; harsh; severe
risible	funny
risqué	daring or not proper
rite	a ceremony
robust	strong
rogue	a dishonest person
role	from memory
rollicking	carefree
roster	a list
rote	from memory
rout	overwhelming defeat
rudimentary	elementary
rue	to regret
ruffian	lawless person
ruffle	a wrinkle or to irritate
ruminate	to think about carefully
ruse	a trick or deception
rustic	pertaining to the country
rustle	to steal or a swishing sound
ruthless	cruel
saccharine	overly sweet
sacrilege	the violation of things sacred
sacrosanct	extremely holy
sadistic	pleasure from inflicting pain
saga	a long story
sage	a wise person
salacious	obscene
salient	significant
saline	salty
sallow	sickly; pale
salubrious	healthful
salutary	healthful; wholesome
salutatory	a welcoming speech
sanctimonious	hypocritical
sanction	to authorize
sangfroid	calmness
sanguinary	bloody
sanguine	cheerful or hopeful
sapient	wise
sardonic	mocking
sartorial	pertaining to tailoring or clothes
satiated	satisfied; filled up
satirical	sarcastic; ironic
saturate	to soak; to fill up
saturnine	gloomy; sluggish
saunter	to stroll; to walk leisurely
savant	a person of extensive learning
savor	to enjoy
scant	inadequate in size or amount
scapegoat	one who takes the blame
scathing	very severe or harsh
schism	a split or break
scintilla	a tiny amount
scintillate	to sparkle
scion	a descendant
scoff	to ridicule
scope	range; extent
scourge	a person or thing that punishes
scrupulous	honest or exact; careful; diligent
scrutinize	to examine closely
scurrilous	abusive or vulgar
scurry	run about; to hurry
scuttle	to abandon
sear	to burn
sebaceous	fatty
secrete	to hide or conceal
secular	worldly
sedate	quiet or calm
sedentary	sitting most of the time
sediment	material that settles on the bottom; residue
sedition	rebellion
sedulous	hard-working; industrious; diligent
seedy	run-down
seethe	to be violently angry
semblance	outward appearance
senile	mental weakness; old or aged
sensual	pertaining to pleasure
sententious	using wise sayings
sentient	conscious
sentinel	a guard
sepulcher	a tomb
sequel	an event following a previous one
sequester	to separate
seraphic	pure
serendipity	a talent for valuable things by accident
serene	peaceful
serpentine	winding or crafty
serrated	having tooth-like edges
servile	acting like a slave; submissive
servitude	slavery
sever	to separate or cut
shackle	to restrain
sham	a pretense
shard	a fragment
sheepish	bashful
shibboleth	a password
shiftless	lazy
shoal	a shallow place in the water
shrew	a nagging woman
shroud	a sheet in which a body is wrapped for burial
sibilant	hissing
sibling	a brother or sister
simile	a comparison using like or as
simper	a silly smile
simulacrum	superficial likeness or image
simulate	to pretend; to imitate
simultaneous	occurring at the same time
sinecure	job with no real work
sinewy	tough or firm
singular	extraordinary or exceptional
sinister	threatening; evil
sinuous	winding
siren	an attractive but dangerous woman
skeptic	one who doubts
skinflint	stingy person
skittish	excitable or nervous
skulduggery	deception
skulk	to sneak around
slake	to quench or satisfy
slander	to speak falsely against someone
slattern	an untidy woman
slither	to slide or glide
slough	to discard
slovenly	untidy or dirty
smirk	an offensive smile
smite	to hit forcefully
smolder	to burn without flame; to conceal hostility
smug	self-satisfied
snare	to trap
sneer	to look at with contempt
snicker	to laugh in a suppressed way
snippet	a small part
snivel	to whine; to complain
sober	not drunk; serious; solemn
sobriquet	assumed name
sodden	soaked, damp
sojourn	a brief stay or visit
solace	comfort
solecism	ungrammatical usage
solemn	serious; grave
solicit	to ask; to seek
solicitude	concern
soliloquy	talking to oneself
solitude	loneliness; being alone
solon	a wise man
solvent	the ability to pay; a substance that dissolves another
somber	dark or gloomy
somnambulate	walk in one's sleep
somnolent	drowsy; sleepy
sonorous	resounding
sophistry	seemingly believable but false reasoning
sophomoric	immature
soporific	sleep inducing
sordid	filthy; base; vile
sovereign	supreme in power
spangle	small metallic ornamentation sewn to clothing
sparse	not thick; thinly scattered; scanty
spasm	fitful, involuntary contraction
spate	sudden flood or strong outburst; a large number or amount
specious	seemingly reasonable but incorrect
specter	ghost-like image
sphinx-like	mysterious
splenetic	spiteful; irritable
sporadic	occurring irregularly
spry	active; nimble
spume	foam
spurious	false; counterfeit
spurn	reject
squalid	dirty; poor
squander	waste
staccato	done in a sharp or abrupt manner
stagnant	motionless; stale; not moving
staid	serious; sedate
stalemate	deadlock
stalwart	strong; steadfast
stamina	staying power
stanch	check the flow of
stanza	a section of a poem
stark	real; unadorned
static	unchanging; stationary; not moving
stationary	not moving
statute	law
steadfast	loyal
stentorian	extremely loud
stereotype	fixed representation; not original
sterling	outstanding
stigma	mark of disgrace
stilted	pompous; inflated
stint	assigned amount of work
stipend	pay for services
stipulate	special condition or demand
stoic	indifferent to pleasure or pain
stolid	dull; unemotional
stratagem	deceptive scheme
strew	scatter
striated	parallel bands or grooved
stricture	critical comments
strident	loud and harsh
stringent	binding; rigid; harsh; strict
strut	pompous walk or supporting bar
stultify	cause to appear foolish
stupefy	to make dull
stygian	gloomy; deathly
stymie	to block or slump
suave	smooth
subjective	personal
subjugate	to conquer; bring under control
sublimate	purify
sublime	exalted; noble
subliminal	below conscious thought
submission	yielding to; surrender
subordinate	inferior
subsequent	following
subservient	behaving like a slave
subside	settle down; descend
subsidiary	subordinate; secondary
subsistence	minimum means of support
substantiate	verify or support
substantive	essential
subterfuge	pretense
subtle	not obvious; hard to see
subtlety	cunning; delicacy
subversive	to overthrow or ruin
succinct	brief; compact
succor	aid; assistance
succulent	juicy; richness
succumb	give in
suffrage	right to vote
suffuse	to spread
sully	tarnish; soil
sultry	hot; sweltering
sumptuous	lavish; rich
supercilious	contemptuous; arrogant; haughty
superficial	shallow; on the surface only
superfluous	excessive; unnecessary
supernal	heavenly
supernumerary	in excess of what is necessary
supersede	to be set aside; replace
supine	lying on the back
supplant	replace
supple	flexible
supplement	added to
suppliant	entreating; pleading
supplicate	to implore or beg for
supposititious	assumed; hypothetical
surcease	cessation
surmise	assume
surpass	exceed
surreptitious	secret
surrogate	substitute
surveillance	watching
susceptible	easily influenced; having little resistance
sustenance	means of support
suture	stitches
swarthy	dark
swathe	wrap around; bandage
sybarite	lover of luxury
sycophant	a flatterer
sylvan	pertaining to the woods; rustic
symbiosis	a close, beneficial association of two organisms
symmetry	balanced arrangement
synchronous	working together at the same time
synthesis	combining parts into a whole
synthetic	artificial
tableau	a graphic picture
taboo	prohibited act
tacit	expressed without words
taciturn	silent; talking little
tactile	pertaining to the sense of touch
taint	to contaminate; corrupt
talisman	a charm
tally	to add up
tangent	touching or a change of course
tantalize	tease
tantamount	equal
tarry	delay
taunt	to ridicule
taut	tight; ready
tawdry	cheap and gaudy
tedious	boring; tiring
temerity	boldness
temperate	mild or self-controlled
temper	restrain; toughen
temporal	not lasting forever
temporize	avoid committing oneself; gain time
tenacious	holding fast
tenacity	persistency
tendentious	biased
tenet	doctrine; beliefs
tensile	capable of being stretched
tentative	temporary; hesitant
tenuous	rare; slim
tenure	time of holding an office
tepid	lukewarm
terminate	to end
terminus	last stop
terrestrial	earthly
terse	brief
testy	irritable
theocracy	government by religious leaders
therapeutic	pertaining to the treatment of disease
thermal	pertaining to heat
thesaurus	a book of synonyms and antonyms; a dictionary
thespian	an actor
thrall	a slave
threnody	a funeral song
throes	a violent struggle; in agony
throng	a crowd
thwart	to prevent
timorous	cowardly
tinge	a trace
tirade	an angry speech
titanic	huge
titillate	to excite
titter	a nervous laugh
token	a symbol; unimportant
tome	a large book
toothsome	tasty
torpid	sluggish
torsion	twisting; bending
torso	the trunk of the human body
tortuous	twisting or winding
touchstone	standard; benchmark
tractable	easy to manage
traduce	to slander
trait	a characteristic
tranquil	calm
transcendental	supernatural
transcend	to go beyond
transgression	a violation
transient	temporary
transitory	brief
translucent	letting light through
transmute	to change from one form to another
transparent	easily seen through
transpire	to occur
trappings	articles of dress or equipment
trauma	a shock
travail	hard work
travesty	a poor imitation
treacherous	disloyal or dangerous
treatise	a book about one particular subject
treble	three times as much
tremulous	trembling
trenchant	vigorous or effective
trepidation	fear
tribulation	trouble
tributary	a stream flowing into a river
tribute	a gift to show respect
trinity	group of three
trite	worn out or commonplace
trivia	things that are very unimportant
truckle	to submit
truculent	brutal or cruel
truism	obvious truth
truncate	to shorten
truncheon	a club
tryst	a secret meeting
tumid	swollen
tumult	great noise
turbid	unclear
turgid	swollen
turpitude	shameful behavior
tussle	a fight
tutelage	instruction; under a tutor
twain	two
tyro	a beginner
ubiquitous	present everywhere
ulcerous	infected
ulterior	hidden
ultimatum	a final demand
umbrage	a feeling of resentment
unanimity	agreement
unassailable	unable to be attacked
uncanny	strange
unconscionable	unreasonable or excessive
uncouth	crude
unctuous	overly polite
undermine	to weaken; to wear away
undue	inappropriate
undulate	wavelike motion
unequivocal	definite
unfledged	immature
uniform	constant; lacking variety
unilateral	one-sided
unimpeachable	unquestionable
uninhibited	free; not limited
universal	general or everywhere
unkempt	sloppy
unmindful	unaware
unmitigated	absolute
unobtrusive	not noticeable
unprecedented	happening for the first time; novel
unruly	disorderly
unsavory	unpleasant
unscathed	unharmed
unseemly	in poor taste
untenable	unable to be defended
unwieldy	hard to manage
unwitting	unintentional
upbraid	to find fault with
uproarious	loud
urbane	refined
urchin	a mischievous child
usurp	to take illegally
usury	excessive amount of money charged as interest
utilitarian	practical
utopian	perfect
vacillate	to sway; unable to decide; waffle
vacuous	empty, spacious
vagabond	a wanderer
vagary	an odd idea
vagrant	a homeless person; a tramp
vainglorious	boastful
valedictory	saying farewell
valiant	courageous
validate	to approve; to confirm
valid	true factual; evident
vanguard	in the front
vanity	excessive pride
vapid	uninteresting
variegated	having different colors
vaunt	to brag
veer	to change direction
vegetate	lead an inactive life
vehement	forceful; urgent
venal	corrupt
vendetta	bitter feud
veneer	an outward show or covering
venerable	worthy of respect
venial	excusable
venomous	poisonous or malicious
vent	to release
veracious	honest
verbatim	word for word
verbiage	words
verbose	wordy; talkative
verdant	green
verisimilitude	the appearance of truth
veritable	true; genuine
verity	truth
vernacular	informal language
vernal	pertaining to spring
vertex	highest point
vertiginous	unstable
verve	enthusiasm
vestige	a trace; visible evidence of something that is no longer present
vex	to irritate
viable	capable of living; workable; practicable
viaduct	a bridge
viands	various foods
vicarious	acting for another person
viceroy	a representative or a deputy
vicissitudes	unpredictable changes
victuals	food
vie	to compete
vigilant	watchful
vignette	a short literary work
vilify	to speak evil of
vindicate	to clear of guilt
vindictive	seeking revenge
vintage	representative of the best
viper	a poisonous snake or a spiteful person
virago	a bad-tempered woman
virile	masculine
virtue	moral excellence
virtuoso	an expert musician
virulent	deadly; harmful
visage	appearance
visceral	pertaining to instinct
viscous	sticky
vista	a wide view
vital	necessary; essential
vitiate	to weaken
vitreous	clear or glass-like
vitriolic	sharp or bitter
vituperate	criticize
vivify	to enliven
vixen	female fox or bad-tempered woman
vociferous	shouting; talkative
vogue	fashion, (in fashion)
volant	capable of flying
volatile	unstable; explosive; changeable
volition	free will
voluble	talkative
voluminous	large; spacious
voluptuous	sensual
voracious	extremely hungry or greedy
votary	a loyal follower
vouch	to guarantee or certify as true
vulnerable	defenseless, capable of being harmed
vulpine	clever
waif	a homeless person
waive	to give up
wallow	to indulge oneself or to roll in
wane	to gradually decrease
wangle	to manipulate
wanton	reckless
wan	weak; tired
warble	to sing
wary	cautious
wastrel	one who wastes; a spendthrift
waver	to be uncertain
wax	to grow in size or intensity
weighty	of great importance
wend	to direct one's way
wheedle	to persuade
whet	to stimulate or to sharpen
whimsical	unpredictable
wield	to handle or exercise control over
willful	stubborn or intentional
wily	tricky; sly
wince	to shrink, as in pain, fear, etc; to flinch
windfall	unexpected gift
winsome	pleasing
wizened	withered; shriveled
woe	sorrow
wolfish	ferocious
wont (to)	accustomed (adjective)
workaday	ordinary
wraith	a ghost or shadow
wrangle	to quarrel
wrench	to test
wrest	to take away
wroth	angry
wrought	produced or shaped
wry	ironic
xenophobia	fear of strangers
xeric	dry, lacking moisture
yen	strong desire
yoke	to join together
zany	comical
zeal	great enthusiasm
zealot	a fanatic
zenith	the highest point
zephyr	a gentle breeze
zest	enjoyment
zymurgy	fermentation chemistry, as in wine making
